15 15
T T T T T T T T T T T T T T T 
T B B B B B C B B B B B B T T 
T B T T T T C T T T T T C C T 
T B T L L L M L L L L L L C T 
T B T L L L M L L L L L L C T 
T B T L L L M L L T T T M C T 
T B T L L T T L L T T T L B T 
T B T L L T T M M T T T L B T 
T C C M M T T L L T T T L B T 
T B T L L L L L L L M L L B T 
T B T L L L L L L L M L L B T 
T B T T T T T T T T C T T B T 
T B T T T B C C C C C C C C C 
T B B B B B T T T C T T T T T 
T T T T T T T T T C T T T T T
